
NO textures/xpm/eagle.xpm
SO textures/xpm/colorstone.xpm
EA textures/xpm/wood.xpm
WE textures/xpm/purplestone.xpm

C 50,167,255
F 59,59,59

1111111
1E00001
111111
