
EA textures/xpm/bluestone.xpm
NO textures/xpm/eagle.xpm
SO textures/xpm/colorstone.xpm
WE textures/xpm/purplestone.xpm

F 59,59,59
C 50,167,255

111111111111111111
100000000000000001
100000000000000001
10000E000000000001
100000000000000001
100000000000000001
111111111111111111