
NO textures/xpm/eagle.xpm
SO textures/xpm/colorstone.xpm
EA textures/xpm/wood.xpm
WE textures/xpm/purplestone.xpm

F 50,167 ,255
C 50,167 ,255

1111 111
1E00101
111111
111111
