
NO textures/xpm/NO.xpm
EA textures/xpm/EA.xpm
SO textures/xpm/SO.xpm
WE textures/xpm/WE.xpm

F 59,59,59
C 50,167,255

1111111111111111111
100S000000000000001
1000000000000000001
1000000000010000001
1000000000000000001
1001000000000010001
1000000000000100001
1000000010000000001
1000000000000000001
1000000000000000001
1111111111111111111