
NO textures/xpm/NO.xpm
EA textures/xpm/EA.xpm
SO textures/xpm/SO.xpm
WE textures/xpm/WE.xpm

F 59,59,59
C 50,167,255

11111111
100S0011
10000011
10000111
10000011
10010011
10000011
10000011
10000011
10000111
11111111