
NO textures/square_dark_gray.xpm
EA textures/square_dark_gray.xpm
SO textures/square_dark_gray.xpm
WE textures/square_dark_gray.xpm

F 0,0,255
C 204,0,102

111111111111111111111111111
100000000000000001111111111
1000000000000N0000000000001
100000000000000000000000001
100000000011111111000000001
111111111111111111111111111