
NO textures/xpm/NO.xpm
EA textures/xpm/EA.xpm
SO textures/xpm/SO.xpm
WE textures/xpm/WE.xpm

F 161, 161, 160
C 0, 255, 255

1
11111111111
10000000001
10100000W01
11111111111
1