
NO textures/xpm/NO.xpm
EA textures/xpm/EA.xpm
SO textures/xpm/SO.xpm
WE textures/xpm/WE.xpm

F 59,59,59
C 50,167,255

11111111111111111
10000000000000001
10100000000000101
100000000000E0001
10100000000000101
11111111111111111