
NO textures/square_dark_gray.xpm
EA textures/square_dark_gray.xpm
SO textures/square_dark_gray.xpm
WE textures/square_dark_gray.xpm

F 0,0,255
C 204,0,102

1111111111111111
1N00000000000001
1000000000000001
1000011110000001
1000010000000001
1000000000111111
1111111111111111