
NO textures/xpm/NO.xpm
EA textures/xpm/EA.xpm
SO textures/xpm/SO.xpm
WE textures/xpm/WE.xpm

F 161, 161, 160
C 0, 255, 255

1111111111111
1000000000001
1001000011001
1000000100001
100000E000001
1000000000001
1001000001001
1111111111111
