
NO textures/xpm/NO.xpm
EA textures/xpm/EA.xpm
SO textures/xpm/SO.xpm
WE textures/xpm/WE.xpm

F 0,0,255
C 204,0,102

1111111111111
1000000000001
1001000011001
1000000100001
100000E000001
1000000000001
1001000001001
1111111111111
