
NO textures/xpm/NO.xpm
EA textures/xpm/EA.xpm
SO textures/xpm/SO.xpm
WE textures/xpm/WE.xpm

F 0,0,255
C 204,0,102

1111111111111111
1000000000000101
100010N010110001
1000000100000001
1000000010000001
1000000000111111
1111111111111111
